xxxxxxxxxxxxxxxx
x x s      v   x
x xv    v      x
x x  xxxxxxxx sx
x xs xx        x
x x vxx xxxxxx x
x x  xx  s s xsx
x x sxx v v vx x
x xv xxs s s xsx
x    xx v v  x x
x s  xxs x xs fx
xxxxxxxxxxxxxxxx